[ ][ ][#][p][#][ ][ ][ ]
[ ][ ][#][ ][#][ ][ ][ ]
[ ][ ][ ][ ][ ][ ][ ][ ]
[ ][ ][ ][ ][ ][ ][ ][ ]
[ ][ ][ ][ ][$][ ][ ][ ]
[ ][ ][ ][m][ ][ ][ ][ ]
[ ][ ][ ][ ][$][ ][ ][ ]
[ ][ ][ ][m][ ][ ][ ][ ]