[ ][ ][#][p][#][ ][ ][ ]
[ ][ ][#][ ][#][ ][m][ ]
[ ][ ][ ][ ][ ][ ][ ][ ]
[ ][ ][#][ ][ ][ ][ ][ ]
[ ][ ][m][ ][ ][ ][ ][ ]
[ ][ ][ ][ ][ ][#][ ][ ]
[ ][ ][ ][ ][ ][ ][$][ ]
[$][ ][ ][ ][ ][ ][ ][ ]