[ ][$][#][p][#][ ][ ][ ]
[ ][#][#][ ][#][ ][m][ ]
[ ][ ][ ][ ][#][ ][ ][ ]
[ ][ ][ ][ ][ ][ ][ ][ ]
[ ][#][#][ ][ ][ ][ ][ ]
[m][ ][ ][ ][ ][#][#][ ]
[ ][ ][m][ ][ ][#][$][ ]
[ ][ ][ ][ ][ ][ ][ ][ ]